111111111
10C0E0P01
111111111
