1111101111
00PEC000C0
1111101111
