11111011
10010011
00PEC00C
10000001
111111111
