11111011
10010010
00PEC00C
11111011
