



1111111111
10PEC000C1
1111111111




