11111011
100100111
00PEC00C
10Y00001
111
